############################
#S....L....///......///...E#
#..##############..#########
#..#............#..#.......#
#..#....L.......#..#..//...#
#..#............#..#.......#
#..##############..#########
#.........................#
############################s