###################
#S....L....../....E#
#.....#######......#
#.....#.....#..L...#
#..../#.....#......#
#.....#.....#......#
#.....#######......#
#..................#
###################