###################
#S.../..L...../..E#
#.....#########...#
#.....#.......#...#
#..L..#..///..#...#
#.....#.......#...#
#.....#########...#
#..................#
###################