########################
#S..../...L...../....E#
#....####....####.....#
#....#..#....#..#.....#
#....#..#....#..#..L..#
#....#..####.#..#.....#
#.....................#
########################