###################
#S....L....../...E#
#.....#######.....#
#.....#.....#..L..#
#..../#.....#.....#
#.....#.....#.....#
#.....#######.....#
#.................#
###################