############
#S....#....E#
#.....#....##
#..../#.....#
#.....#.....#
#..L..#.....#
#.....#.....#
#.....#.....#
#.....#.....#
#..........##
############