#############
#S...#....../#
#....#....L.#
#....###....#
#...........#
#..###......#
#..#....#...#
#..#....#...#
#..#....#...#
#.....E.....#
#############