#########################
#S L                    #

#####################

#

# # # # # # # # # # #

# # # # # # # # # # #

# # # # # # # # # # #

# # # # # # # # # # #

# # # # # # # # # # #

# # # # # # # # # # #

# # # # # # # # # # #

# # # # # # # # # # #

# # # # # # # # # # #

# # # # # # # # # # #

# # # # # # # # # # #

# # # # # # # # # # #

L                   E

#########################