################################
#S.....#.......................#
#......#.......................#
#......#.......................#
#...../#.......................#
#......#.......................#
#..L...#.......................#
#......#.......................#
#......#.......................#
#......#.......................#
#..............................#
#..............................#
#..............................#
#..............................#
#..............................#
#..............................#
#.............................E#
################################