#########################
#S #################### #

# L

## ### ####### # / #

#  # / # L / # # / #

## # / # ### # # ###

#  # ### #   # # #

####################

L / /

####################

# # # # # # # # # # #

# # # # # # # # # # #

# # # # # # # # # # #

# # # # # # # # # # #

# # # # # # # # # # #

# # # # # # # # # # #

# L / /             # E

#########################