####################
#S.................E#
#..##########..L....#
#..#........#.......#
#..#..////..#.......#
#..#........#.......#
#..##########.......#
#...................#
####################