#########################
#S                     #

#####################

#                   #

# L / /             #

# ###################

#

#####################

#####################

#

#

#####################

#

# ###################

# L / /             #

#####################

#####################E##