################################
#S.....#.......................#
#......#.......................#
#......#.......................#
#......#......../..............#
#......#.......................#
#..L...#................X......#
#......#.......................#
#......#.......................#
#......#.......................#
#..............................#
#..............................#
#..............................#
#..............................#
#..............................#
#..............................#
#.............................E#
################################