################
#S....#......E.#
#.....#........#
#..L..#..../...#
#.....#........#
#.....##########
#...............#
#...............#
################