#########################
#S L / / L / / L / / E #

# # # # # # # # # # #

# # # # # # # # # # #

# L # # / # # / # # L

# # # # # # # # # # #

# # # # # # # # # # #

# L # # / # # / # # L

# # # # # # # # # # #

# # # # # # # # # # #

# L # # / # # / # # L

# # # # # # # # # # #

# # # # # # # # # # #

# L # # / # # / # # L

# # # # # # # # # # #

# # # # # # # # # # #

# L / / L / / L / / #

#########################