########################
#S.....L....////......E#
#..#########...........#
#..#........#....L.....#
#..#........#..........#
#..#........#########..#
#......................#
########################