#########################
#S L # # # # # # # # L #

## # / # / # / # / #

#  # # # # # # # # #

# ## # / # / # / # /

#  # # # # # # # # #

# ## # / # / # / # /

#  # # # # # # # # #

# ## # / # / # / # /

#  # # # # # # # # #

# ## # / # / # / # /

#  # # # # # # # # #

# ## # / # / # / # /

#  # # # # # # # # #

# ## # / # / # / # /

#  # # # # # # # # #

L                    E

#########################