####################
#S..../.....L.....E#
#......####........#
#......#..#........#
#..#####..#........#
#......#..#........#
#......#..##########
#...................#
####################