################
#S.../....L...E#
#..............#
#..####..####..#
#..#..........##
#..#....L.......#
#..#.........../#
#...............#
################