################
#S...L...../..E#
#....####......#
#..............#
#..####..####..#
#..............#
#....L.........#
#..............#
################