#########################
#S L         L         #

############/########

#         #/#

# ####### #/# #######

# / #   # #/# # #   #

# # # / # #/# # # / #

# # # # # #/# # # # #

# L / #   #/# # L / #

##########/#

# / # L / # # # / # E

# # # # # # # # # # #

# / # # # # # # / # #

# ####### # # #######

# L       # #

###########

L           L

#########################